###################################
#S..#...........#...............#.#
#.#.#.###.#####.#.#############...#
#.#.....#.#...#.#.#.........#.#.#.#
#.#####.#.#.#.#.#.#.#######.#.#.#.#
#.#.....#.#.#.#.#.#.#.....#.#...#.#
#.#.#####.#.#.#.#.#.#.###.#.#####.#
#.#.#.....#.#.#.#.#.#...#.#.....#.#
#.#.#.#####.#.#.#.#.###.#.#####.#.#
#.#.#.#...#.#.#...#...#.#.....#.#.#
#.#.#.#.#.#.#.#######.#.#####.#.#.#
#.#.#...#.#.#.......#.#.....#...#.#
#.#.#####.#.#######.#.#####.#####.#
#.#.......#.#.....#.#.....#.....#.#
#.#########.#.###.#.#####.#####.#.#
#...........#...#.#.....#.....#.#.#
#############.#.#.#####.#####.#.#.#
#...........#.#.#.....#.#...#.#.#.#
#.#########.#.#.#####.#.#.#.#.#.#.#
#.#.......#.#.#.....#.#.#.#.#.#.#.#
#.#.#####.#.#.#####.#.#.#.#.#.#.#.#
#.#.#...#.#.#.#...#.#.#.#.#...#.#.#
#.#.#.#.#.#.#.#.#.#.#.#.#.#####.#.#
#.#...#.#.#.#.#.#.#.#.#.#.....#.#.#
#.#####.#.#.#.#.#.#.#.#.#####.#.#.#
#.#.....#.#.#.#.#.#.#.#.#...#...#.#
#.#.#####.#.#.#.#.#.#.#.#.#.#####.#
#.#.......#.#.#.#...#.#.#.#.....#.#
#.#########.#.#.#####.#.#.#####.#.#
#...........#.#.......#.#.....#...#
#.###########.#########.#####.###.#
#.................#.......#.....#G#
###################################