#####################
#S....#...........#.#
#.#.#.###########.#.#
#.#.#...........#.#.#
#.#.#.#########.#.#.#
#.#.#.#.......#.#.#.#
#...#.#.#####.#.#.#.#
#.#.#.#.#...#.#.#.#.#
#.#.#.#.#.#.#.#.#...#
#.#.#.#.#.#.#.#.###.#
#.#.#.#.#.#.#.#.#.#.#
#.#.#.#.#.#.#.#..G#.#
#####################