########
#S.....#
#####.##
#####.##
#####.G#
########
