#########
#S..#...#
#.#.#.#.#
#.#...#.#
#.#####.#
#.......#
#.#######
#...#...#
###.#.#G#
#.....#.#
#########