#######
#S....#
#.###.#
#...#.#
###.###
#....G#
#######
